#####
# A #
# @ #
# o #
#####