########
#  o o #
#@  @  #
#o  @  #
# A    #
########
